{
  "width": 10,
  "height": 10,
  "spawnCoordinates": [ 1, 1 ],
  "exitCoordinates": [ 1, 8 ],
  "wallLayer": [
    1,1,1,1,1,1,1,1,1,1,
    1,0,0,0,0,0,0,0,0,1,
    1,0,0,0,0,0,0,0,0,1,
    1,1,1,1,1,0,0,0,0,1,
    1,0,0,0,0,0,0,1,1,1,
    1,0,1,0,1,1,0,0,0,1,
    1,0,1,0,1,1,0,0,0,1,
    1,0,1,0,0,0,0,0,0,1,
    1,0,1,0,1,1,1,1,1,1,
    1,1,1,1,1,1,1,1,1,1
  ],
  "itemsLayer": [
    0,0,0,0,0,0,0,0,0,0,
    0,0,0,0,0,0,0,0,1,0,
    0,0,0,0,0,0,0,0,0,0,
    0,0,0,0,0,0,0,0,0,0,
    0,0,0,0,0,0,0,0,0,0,
    0,0,0,0,0,0,0,0,0,0,
    0,0,0,0,0,0,0,0,0,0,
    0,0,0,0,0,0,0,0,1,0,
    0,0,0,1,0,0,0,0,0,0,
    0,0,0,0,0,0,0,0,0,0
  ],
  "ghostPowerUpLayer": [
    0,0,0,0,0,0,0,0,0,0,
    0,0,0,0,0,0,0,0,1,0,
    0,0,0,0,0,0,0,0,0,0,
    0,0,0,0,0,0,0,0,0,0,
    0,0,0,0,0,0,0,0,0,0,
    0,0,0,0,0,0,0,0,0,0,
    0,0,0,0,0,0,0,0,0,0,
    0,0,0,0,0,0,0,0,1,0,
    0,0,0,1,0,0,0,0,0,0,
    0,0,0,0,0,0,0,0,0,0
  ]
}